#######################
#.....................#
|.....................|
#.....................#
#.....................#
###########|###########
#.....................#
#.....................#
#.....................#
#.....................#
#.....................#
###########|###########