1111111111111111111111111111111111111111
1000000000000000000000100000000000000001
1000000000000000000000100001000000100001
1000000000000000000000111111000000111111
1000000000000000000000100001000000100001
1111111111000111111111100000000000000001
1000000000000000000000100001000000100001
1000000000000000000000111111000000111111
1000000000000000000000100000000000000001
1000000000000000000000100001000000100001
1111111111000111111111111111101101111101
1000000000000000100000001000000000000001
1000000000000000000000000000000000000001
1000000000000000000000000000000000000001
1000000000000000000000000000000000000001
1000000000000000000000000000000000000001
1100111111111110000000000011111111110011
1000000001000010000000000010000000000001
1000000000000010000000000010000000000001
1000000001111110000000000010000000000001
1000000000000010000000000010000000000001
1000000001000010000000000010000000000001
1111111111111111111111111111111111111111
