########################################
#.....................#................#
#.....................#....#......#....#
#.....................######......######
#.....................#....#......#....#
##########...##########................#
#.....................#....#......#....#
#.....................######......######
#.....................#................#
#.....................#....#......#....#
##########...################....#####.#
#...............#.......#..............#
#......................................#
#......................................#
#......................................#
#......................................#
#......................................#
#......................................#
#......................................#
#......................................#
#......................................#
#......................................#
#......................................#
#......................................#
#......................................#
#......................................#
#......................................#
#......................................#
#......................................#
#......................................#
#......................................#
#......................................#
#......................................#
#......................................#
##..###########...........##########..##
#........#....#...........#............#
#.............#...........#............#
#........######...........#............#
#.............#...........#............#
#........#....#...........#............#
########################################