########################################
#.....................#................#
#.....................#................#
#.....................#................#
#.....................#................#
##########...##########................#
#.....................#................#
#.....................######.....#######
#.....................#................#
#.....................#................#
##########...################....#####.#
#........#......#.......#..............#
#........#......#.......#..............#
#........#......#.......#..............#
#........#......####.####..............#
#........#.............................#
#........#.............................#
#......................................#
#......................................#
#......................................#
#......................................#
#......................................#
#........#.............................#
#........#.............................#
#........#.............................#
#........#.............................#
#........#.............................#
#........###########.....###############
#......................................#
#......................................#
#......................................#
#......................................#
#......................................#
#......................................#
##..###########...........##########..##
#........#....#...........#............#
#........#....#...........#............#
#........##.###...........#............#
#........#....#...........#............#
#.............#...........#............#
########################################